  *****@************
 ***@*@@@***********
********************
@@@***@@@***********
********************
********************
@@@@@@@@@@**********
********************
 *******************
  *****@@@**********
*****@**************
 ***@*@@@***********
********************
@@@***@@@***********
********************
********************
@@@@@@@@@@**********
********************
 *******************
  *****@@@**********