  *****@**
 ***@*@@@*
**********
@@@***@@@*
**********
**********
@@@@@@@@@@
**********
 *********
  *****@@@