     **@*****************
 *   *@@@****************
**** ********************
@@@*  @@@****************
****        *************
*********   *************
@@@@@@@@@   *************
*********   *************
 **********    **********
  *****@@@*    **********
*****@*******************
 ***@*@@@****************
*************************
@@@***@@@****************
*************************
*************************
@@@@@@@@@@***************
*************************
 ************************
  *****@@@***************