     **@************
 *   *@@@***********
**** ***************
@@@*  @@@***********
****        ********
*********   ********
@@@@@@@@@   ********
*********   ********
 **********    *****
  *****@@@*    *****
*****@**************
 ***@*@@@***********
********************
@@@***@@@***********
********************
********************
@@@@@@@@@@**********
********************
 *******************
  *****@@@**********