     **@************
 *   *@@@***********
  ** ***************
  @*  @@@***********
  **        ********
  *******   ********
  @@@@@@@   ********
 ********   ********
 **********    *****
  *****@@@*    *****
 ****@**************
 ***@*@@@***********
 *******************
 @@***@@@***********
 *******************
 *******************
 @@@@@@@@@**********
 *******************
 *******************
  *****@@@**********