  *****@*************!!!!
 ***@*@@@****************
*************************
@@@***@@@****************
*************************
*************************
@@@@@@@@@@***************
*************************
 **********    **********
  *****@@@*    **********
*****@*******************
 ***@*@@@****************
*************************
@@@***@@@****************
*************************
*************************
@@@@@@@@@@***************
*************************
 ************************
  *****@@@***************
*************************
*************************
*************************
*************************
*************************